::.:::::::::::::::.:.:.:.::.:.::
.:::...:..:::..::::...::..:.::.:
:.::.::.::...:..::..::...:.::.:.
::::..::::::::..:..:.:.:.:::::::
.:...:.::.:::..:...:.:..::.:.:..
:....:..:::.:.::..:...:...:.::..
.:::::..:..::.::...:......:...:.
:.::...::.:::..:.:::....::::....
..::::.....:::::.::::..:.....:.:
.:.::...:...:::..::.:::.:...:...
::.::.::::::.::.::::...:.::.:.:.
.:.:::::.:.::...:.::....:..::...
..::.:...:..::::.:.:..::::.::.:.
:.:..::.:.:.:.::.::...:.::::::::
..::...:...:.:.::.:.:.:..:::..::
:....:.:.....:::..:.......:...::
....:.::..:.::.:::...:::.:::..::
::.::..:..::.::::.:..::.:..:::::
::.:.::.:::.:::..:..:...:::.::..
...::..::....:::.:..::.:::::..::
.:.::.::..:..:::..:....:...::.::
:::..:.:.:::.:.:.:::.:.:.::::.:.
.::.:.:....:.......:::.:::.:::::
:.:..::.:.:....:::.::.:...:::::.
.:::.::::..::...:.:.......::....
::.....:::..::.:::::.:::.::.::::
.:.....::....:::.:::..:.:.:::.::
:::....::...::.....::::::.:::.::
..:::.:.:.....:::.::.:.:......::
:::..::::..::::::..:::.:.:..:..:
::..:.:.:.:.......:..::...:.:.::
.:.:.:.:.:.:.:..::::.::...:..:::