,,.,,,,,,,,,,,,,,,.,.,.,.,,.,.,,
.,,,...,..,,,..,,,,...,,..,.,,.,
,.,,.,,.,,...,..,,..,,...,.,,.,.
,,,,..,,,,,,,,..,..,.,.,.,,,,,,,
.,...,.,,.,,,..,...,.,..,,.,.,..
,....,..,,,.,.,,..,...,...,.,,..
.,,,,,..,..,,.,,...,......,...,.
,.,,...,,.,,,..,.,,,....,,,,....
..,,,,.....,,,,,.,,,,..,.....,.,
.,.,,...,...,,,..,,.,,,.,...,...
,,.,,.,,,,,,.,,.,,,,...,.,,.,.,.
.,.,,,,,.,.,,...,.,,....,..,,...
..,,.,...,..,,,,.,.,..,,,,.,,.,.
,.,..,,.,.,.,.,,.,,...,.,,,,,,,,
..,,...,...,.,.,,.,.,.,..,,,..,,
,....,.,.....,,,..,.......,...,,
....,.,,..,.,,.,,,...,,,.,,,..,,
,,.,,..,..,,.,,,,.,..,,.,..,,,,,
,,.,.,,.,,,.,,,..,..,...,,,.,,..
...,,..,,....,,,.,..,,.,,,,,..,,
.,.,,.,,..,..,,,..,....,...,,.,,
,,,..,.,.,,,.,.,.,,,.,.,.,,,,.,.
.,,.,.,....,.......,,,.,,,.,,,,,
,.,..,,.,.,....,,,.,,.,...,,,,,.
.,,,.,,,,..,,...,.,.......,,....
,,.....,,,..,,.,,,,,.,,,.,,.,,,,
.,.....,,....,,,.,,,..,.,.,,,.,,
,,,....,,...,,.....,,,,,,.,,,.,,
..,,,.,.,.....,,,.,,.,.,......,,
,,,..,,,,..,,,,,,..,,,.,.,..,..,
,,..,.,.,.,.......,..,,...,.,.,,
.,.,.,.,.,.,.,..,,,,.,,...,..,,,