::.:::::::::::::::.:.:.:.::.:.::.:::...:..:::
..::::...::..:.::.::.::.::.::...:..::..::...:
.::.:.::::..::::::::..:..:.:.:.:::::::.:...:.
::.:::..:...:.:..::.:.:..:....:..:::.:.::..:.
..:...:.::...:::::..:..::.::...:......:...:.:
.::...::.:::..:.:::....::::......::::.....:::
::.::::..:.....:.:.:.::...:...:::..::.:::.:..
.:...::.::.::::::.::.::::...:.::.:.:..:.:::::
.:.::...:.::....:..::.....::.:...:..::::.:.:.
.::::.::.:.:.:..::.:.:.:.::.::...:.::::::::..
::...:...:.:.::.:.:.:..:::..:::....:.:.....::
:..:.......:...::....:.::..:.::.:::...:::.:::
..::::.::..:..::.::::.:..::.:..:::::::.:.::.:
::.:::..:..:...:::.::.....::..::....:::.:..::
.:::::..::.:.::.::..:..:::..:....:...::.:::::
..:.:.:::.:.:.:::.:.:.::::.:..::.:.:....:....
...:::.:::.::::::.:..::.:.:....:::.::.:...:::
::..:::.::::..::...:.:.......::....::.....:::
..::.:::::.:::.::.::::.:.....::....:::.:::..:
.:.:::.:::::....::...::.....::::::.:::.::..::
:.:.:.....:::.::.:.:......:::::..::::..::::::
..:::.:.:..:..:::..:.:.:.:.......:..::...:.:.
::.:.:.:.:.:.:.:..::::.::...:..:::.:..::.:..:
...:::...::.:::::::::.::...::......::.:..::..
:..:........:..:.:.:.:.:::...:.:..:.::.:.::.:
.:::::..:..:::..::.:..:..::....:.:.....:.::::
:.....::...:::....::::::...:::...:::..:..:..:
.:::.:...:.:..:.::::...:.:...:.:....::..:..:.
:::.::..::::..:.:.:....::::....:::..::...:.::
.::.:::::::.:..:..:::.:::.:...:...:..:.:..::.
.:::.....:::..:..:.:...:...:...::.::.::::...:
::...:.:::...:...:...:::....::.::....:.::....